011000110
111111111
111111111
111111111
001111100
111111111
111111111
111111111
011000110