11111111
01111110
11111111
00111100
00111100
11111111
01111110
11111111